1 1
8 6
-1 -1 -1 -1 -1 -1 -1 -1
-1 0 0 0 107 0 0 0
-1 0 -1 -1 -1 -1 -1 -1
-1 0 -1 -1 -1 -1 -1 -1
-1 0 0 0 0 7 -1 -1
-1 -1 -1 -1 -1 -1 -1 -1