1 1
8 6
-1 -1 -1 -1 -1 -1 -1 -1
-1 0 0 0 8 108 0 0
-1 0 -1 -1 -1 -1 -1 -1
-1 0 -1 -1 -1 -1 -1 -1
-1 0 0 0 0 0 -1 -1
-1 -1 -1 -1 -1 -1 -1 -1